Abel=Эйбел
Abraham=Абрахам
Ada=Ада
Adam=Адам
Agatha=Агата
Agnes=Агнес
Albert=Альберт
Alexander=Александр
Alfred=Альфред
Algernon=Алджернон
Alice=Алиса
Allan=Аллан
Aloys=Алоиз
Amabel=Амабель
Ambrose=Эмброуз
Amelie=Амелия
Andrew=Эндрю
Angelica=Анжелика
Angelina=Ангелина
Ann=Энн
Anna=Анна
Annabel=Эннабел
Anthony=Антони
Antoinette=Антуанетта
Arabella=Арабелла
Archibald=Арчибальд
Arnold=Арнольд
Arthur=Артур
Aubrey=Обри
August=Август
Augustes=Огастес
Aurora=Аврора
Austin=Остин
Boldwin=Болдуин
Barbara=Барбара
Bartholomew=Бартоломео
Basil=Безил
Beatrice=Беатриса
Beatrix=Беатриса
Benedict=Бенедикт
Benjamin=Бенджамин
Bernard=Бернард
Bertram=Бертрам
Blanche=Бланш
Brian=Брайен
Bridget=Бриджит
Candida=Кандида
Carol=Кэрол
Caroline=Каролина
Caspar=Каспар
Catherine=Катрин
Cecil=Сесил
Cecilia=Сесилия
Cecily=Цесилия
Charles=Чарльз
Charlotte=Шарлотта
Christian=Кристиан
Christina=Кристина
Chrictine=Кристин
Christopher=Кристофер
Clara=Клара
Clarence=Клэренс
Clare=Клэр
Claudius=Клавдий
Claud=Клод
Clementina=Клементина
Clement=Клемент
Clifford=Клиффорд
Clothilda=Клотильда
Connor=Коннор
Constance=Констанс
Cora=Кора
Cordelia=Корделия
Cornelia=Корнелия
Cornelius=Корнелий
Cyril=Сирил
Daniel=Дэниел
David=Дэвид
Deborah=Дебора
Dennis=Деннис
Denis=Денис
Desmond=Десмонд
Diana=Диана
Dinah=Дина
Dolores=Долорес
Donald=Дональнд
Dorian=Дориан
Doris=Дорис
Dorothy=Дороти
Douglas=Дуглас
Edgar=Эдгар
Edith=Эдит
Edmund=Эдмунд
Edna=Эдна
Edward=Эдуард
Edwin=Эдвин
Eleanor=Элеонора
Elisabeth=Элизабет
Elizabeth=Елизавета
Elliot=Элиот
Elmer=Элмер
Elvira=Эльвира
Emery=Эмери
Emilia=Эмилия
Emily=Эмили
Emma=Эмма
Emmanuel=Эммануэль
Ernest=Эрнст
Esther=Эстер
Ethel=Этель
Eugene=Юджин
Eustace=Юстас
Evelina=Эвелина
Evelin=Эвелин
Evelyn=Эвелин
Evans=Эванс
Eva=Ева
Eve=Ева
Felicia=Фелиция
Felice=Фелиция
Felix=Феликс
Ferdinand=Фердинанд
Fidelia=Фиделия
Flora=Флора
Florence=Флоренс
Frances=Франциска
Francis=Францис
Frederic=Фредерик
Frederick=Фридрих
Gabriel=Габриэль
Geffrey=Джеффри
Geoffrey=Джеффри
Gefrey=Джефри
George=Джордж
Gerald=Джеральд
Gertrude=Гертруда
Gideon=Гидеон
Gilbert=Гильберт
Gladys=Глэдис
Gloria=Глория
Godfrey=Годфри
Godwin=Годвин
Gordon=Гордон
Grece=Грейс
Graham=Грехем
Gregory=Грегори
Griffith=Гриффит
Guy=Гай
Gwendolen=Гвендолин
Harold=Гарольд
Harriot=Герриетта
Harriet=Герриетта
Harry=Гарри
Helena=Елена
Helen=Элен
Henrietta=Генриетта
Henry=Генри
Herbert=Герберт
Hermann=Герман
Herman=Герман
Hesketh=Хескет
Hilary=Хилари
Hilda=Хильда
Норе=Хоуп
Horace=Горас
Horatio=Горацио
Howard=Говард
Hubert=Хьюберт
Hugh=Хью
Hugo=Хьюго
Humphrey=Хамфри
Humphry=Хамфри
Ida=Ида
Ira=Аира
Irene=Айрин
Isaac=Айзек
Isabella=Изабелла
Isabel=Изабель
Isidore=Исидора
Isolde=Изольда
Isold=Изольда
Israel=Израэль
Jacob=Джекоб
Jack=Джек
James=Джеймс
Janet=Дженет
Jane=Джейн
Jasper=Джаспер
Jean=Джин
Jeffrey=Джеффри
Jemima=Джемайма
Jennifer=Дженифер
Jeremiah=Джереми
Jerome=Джером
Jerry=Джерри
Jessica=Джессика
Jobes=Джобс
Job=Джоб
Joe=Джо
Johann=Йохан
John=Джон
Jonathan=Джонатан
Jones=Джонс
Jordan=Джордан
Jorg=Йорг
Josephine=Джозефин
Joseph=Джозеф
Joyce=Джойс
Joy=Джой
Judith=Джудит
Juliana=Юлиана
Julian=Джулиан
Julia=Джулия
Juliett=Джульетта
Julius=Джулиус
Keit=Кит
Kenneth=Кеннет
Lambert=Ламберт
Laura=Лаура
Laurence=Лоренс
Lawrence=Лаврентий
Lazarus=Лазарь
Leila=Лейла
Leonard=Леонард
Leonora=Леонора
Leopold=Леопольд
Leo=Лео
Lesley=Лесли
Leslie=Лесли
Lewis=Льюис
Lillian=Лилиан
Lily=Лили
Linda=Линда
Lionel=Лайонел
Louisa=Луиза
Lucas=Лукас
Lucy=Люси
Luke=Льюк
Mabel=Мейбл
Magnus=Магнус
Malkolm=Малькольм
Marcus=Маркус
Margaret=Маргарет
Maria=Мария
Marian=Мэриан
Marianne=Марианна
Marina=Марина
Marion=Марион
Mark=Марк
Martha=Марта
Martin=Мартин
Маrу=Мэри
Mathilda=Матильда
Matilda=Матильда
Matthew=Метью
Maurice=Морис
Maximillian=Максимилиан
Mercy=Мерси
Meredith=Мередит
Michael=Майкл
Mildred=Мильдред
Minna=Минна
Mirabel=Мирабель
Miranda=Миранда
Miriam=Мириам
Monica=Моника
Montaguee=Монтегю
Montague=Монтегю
Morgan=Морган
Mortimer=Мортимер
Muriel=Мюриель
Nathan=Натан
Nathaniel=Натаниель
Neville=Невилл
Nicholas=Николас
Nicola=Никола
Noah=Ной
Noel=Наэль
Norman=Норман
Odette=Одетта
Olive=Оливия
Oliver=Оливер
Olivia=Оливия
Ophelia=Офелия
Oscar=Оскар
Osmund=Осмунд
Oswald=Освальд
Ottilia=Оттилия
Owen=Оуэн
Patricia=Патриция
Patrick=Патрик
Paula=Паула
Paul=Поль
Paulina=Полина
Penelope=Пенелопа
Percy=Перси
Peter=Питер
Philip=Филип
Phillip=Филлип
Pius=Пий
Portia=Порция
Rachel=Речел
Ralph=Ральф
Ranald=Ренальд
Randolph=Рандольф
Raphael=Рафаэль
Raymond=Раймонд
Rebecca=Ребекка
Reginald=Реджинальд
Reynold=Рейнольд
Richard=Ричард
Robert=Роберт
Roderick=Родерик
Rodney=Родни
Roger=Роджер
Roland=Роланд
Rolf=Рольф
Romeo=Ромео
Ronald=Рональд
Rosabel=Розабел
Rosalia=Розалия
Rosalind=Розалинда
Rosamund=Розамунда
Rosa=Роза
Rosemary=Розмари
Rose=Роза
Roy=Рой
Rudolf=Рудольф
Rudolph=Рудольф
Rupert=Руперт
Ruth=Рут
Salome=Саломея
Samuel=Сэмюель
Sarah=Сара
Sara=Сара
Saul=Саул
Sebastian=Себастьян
Septimus=Септимус
Sergey=Сергей
Sibil=Сибилла
Sidney=Сидней
Sigfried=Зигфрид
Silas=Сайлас
Silvester=Сильвестр
Silvia=Сильвия
Simeon=Симеон
Simon=Саймон
Solomon=Соломон
Sophia=София
Stanislaus=Станислав
Stanley=Стэнли
Stella=Стелла
Stephanie=Стефания
Stephen=Стивен
Susan=Сюзи
Susannah=Сюзанна
Susanna=Сюзанна
Theobald=Теобольд
Theodora=Теодора
Theodore=Теодор
Theresa=Тереза
Thomas=Томас
Timothy=Тимоти
Tobias=Тобиас
Tristan=Тристан
Tybald=Тибольд
Valentine=Валентайн
Valentin=Валентин
Veronica=Вероника
Victoria=Виктория
Victor=Виктор
Vincent=Винсент
Viola=Виола
Violet=Виолетта
Virdginia=Виргиния
Vivian=Вивиан
Vivien=Вивьен
Bailey=Бэйли
Baker=Бэйкер
Brown=Браун
Carter=Картер
Cook=Кук
Coop=Куп
Doyle=Дойл
Gate=Гейт
Green=Грин
Lee=Ли
MacCar=Маккар
Moore=Мур
Murray=Мюррей
Smith=Смит
Taylor=Тейлор
Turner=Тёрнер
tney=тни
Walker=Уокер
Watson=Уотсон
White=Уайт
Whitn=Уитн
Wilson=Уилсон
Wood=Вуд
Wright=Райт
Young=Юнг
Apple=Эппл
Bing=Бинг
Google=Гугл
Joomla=Джумла
Jow=Джов
Microsoft=Майкрософт
Windows=Виндоус
Yandex=Яндекс
Bia=Биа
bia=биа
CH`=ЧЬ
CHE=ЧЕ
CHI=ЧИ
Chia=Чиа
chia=чиа
CHU=ЧУ
CH=Ч
Ch=Ч
ch=ч
Gia=Гиа
gia=гиа
Dia=Диа
dia=диа
Fia=Фиа
fia=фиа
Kia=Киа
kia=киа
Lia=Лиа
lia=лиа
Mia=Миа
mia=миа
Nia=Ниа
nia=ниа
Pia=Пиа
pia=пиа
Ria=Риа
ria=риа
SHA=ША
SHB=ШБ
SHV=ШВ
SHE=ШЕ
SHI=ШИ
SHK=ШК
SHL=ШЛ
SHM=ШМ
SHN=ШН
SHO=ШО
SHP=ШП
SHR=ШР
SHU=ШУ
SHE`=ШЭ
SHCHA=ЩА
SHCHE=ЩЕ
SHCHI=ЩИ
SHCHU=ЩУ
SHCHIA=ЩЯ
shch=щ
Shch=Щ
Sh=Ш
sh=ш
Sia=Сиа
sia=сиа
Tci=Ци
tcia=циа
USH=УШ
iu=ю
NIU=НЮ
IAKH=ЯХ
Iu=Ю
tia=тиа
Via=Виа
via=виа
zia=зиа
ia=я
IAV=ЯВ
IA =Я 
Ia=Я
cl=кл
cyan=циан
yo=ё
zh=ж
Jour=Джор
jour=джор
i`=й
Ha=Ха
Ho=Хо
Hu=Ху
HI=ХИ
Hia=Хиа
hia=хиа
Hi=Хи
ha=ха
hi=хи
ho=хо
hu=ху
kh=х
ight=айт
tch=тч
cia=циа
tc=ц
th=т
``=ъ
y`=ы
A=А
B`=БЬ
B=Б
CEN=ЦЕН
Cen=Цен
cen=цен
CL=CL
Cl=Кл
V``=Въ
V`=ВЬ
V=В
G`=ГЬ
G=Г
D`=ДЬ
D=Д
E`=Э
E=Е
Yo=Ё
ZH`=ЖЬ
ZH=Ж
Zha=Жа
Zhb=Жб
Zhv=Жв
Zhg=Жг
Zhd=Жд
Zhe=Же
Zhzh=Жж
Zhi=Жи
Zhk=Жк
Zhl=Жл
Zhm=Жм
Zhn=Жн
Zho=Жо
Zhr=Жр
Zhs=Жс
Zht=Жт
Zhu=Жу
Zhy=Жы
Zhe`=Жэ
Zhiu=Жю
Z`=ЗЬ
Z=З
II`=ИЙ
I`=Й
IU=Ю
IA=Я
I=И
KH`=ХЬ
KH=Х
K`=КЬ
K=К

Q=К'
L`=ЛЬ
L=Л
MIA=МЯ
M`=МЬ
M=М
N`=НЬ
N=Н
OI`=ОЙ
O=О
P`=ПЬ
P=П
R`=РЬ
R=Р
S`=СЬ
S=С
T`=ТЬ
TC=Ц
T=Т
UCH=УЧ
U=У
F`=ФЬ
F=Ф
Wat=Ват
W=В'
``=Ъ
YO=Ё
Y=Ы
a=а
b=б
v=в
w=в'
g=г
d=д
e`=э
e=е
z=з
i=и
k=к

q=к'
que=кве
l=л
m=м
n=н
o=о
p=п
r=р
s=с
t=т
u=у
f=ф
`=ь